c_000000000202	Ga0182892_11
c_000000000458	Ga0182892_12
c_000000000336	Ga0182892_13
c_000000000335	Ga0182892_14
c_000000000313	Ga0182892_15
