c_000000000219	Ga0214273_1001
c_000000000218	Ga0214273_1002
c_000000000211	Ga0214273_1003
c_000000000210	Ga0214273_1004
c_000000000213	Ga0214273_1005
c_000000000217	Ga0214273_1006
c_000000000216	Ga0214273_1007
c_000000000100	Ga0214273_1008
c_000000000103	Ga0214273_1009
c_000000000078	Ga0214273_1010
c_000000000108	Ga0214273_1011
c_000000000024	Ga0214273_1012
c_000000000025	Ga0214273_1013
c_000000000022	Ga0214273_1014
c_000000000023	Ga0214273_1015
c_000000000021	Ga0214273_1016
c_000000000294	Ga0214273_1017
c_000000000296	Ga0214273_1018
c_000000000199	Ga0214273_1019
c_000000000227	Ga0214273_1020
c_000000000139	Ga0214273_1021
c_000000000134	Ga0214273_1022
c_000000000135	Ga0214273_1023
c_000000000136	Ga0214273_1024
c_000000000130	Ga0214273_1025
c_000000000131	Ga0214273_1026
c_000000000132	Ga0214273_1027
c_000000000039	Ga0214273_1028
c_000000000038	Ga0214273_1029
c_000000000037	Ga0214273_1030
c_000000000032	Ga0214273_1031
c_000000000628	Ga0214273_1032
c_000000000352	Ga0214273_1033
c_000000000182	Ga0214273_1034
c_000000000187	Ga0214273_1035
c_000000000080	Ga0214273_1036
c_000000000081	Ga0214273_1037
c_000000000230	Ga0214273_1038
c_000000000084	Ga0214273_1039
c_000000000085	Ga0214273_1040
c_000000000086	Ga0214273_1041
c_000000000087	Ga0214273_1042
c_000000000123	Ga0214273_1043
c_000000000252	Ga0214273_1044
c_000000000209	Ga0214273_1045
c_000000000147	Ga0214273_1046
c_000000000006	Ga0214273_1047
c_000000000200	Ga0214273_1048
c_000000000050	Ga0214273_1049
c_000000000151	Ga0214273_1050
c_000000000012	Ga0214273_1051
c_000000000158	Ga0214273_1052
c_000000000159	Ga0214273_1053
c_000000000157	Ga0214273_1054
c_000000000154	Ga0214273_1055
c_000000000152	Ga0214273_1056
c_000000000150	Ga0214273_1057
c_000000000018	Ga0214273_1058
c_000000000233	Ga0214273_1059
c_000000000316	Ga0214273_1060
c_000000000011	Ga0214273_1061
c_000000000010	Ga0214273_1062
c_000000000062	Ga0214273_1063
c_000000000063	Ga0214273_1064
c_000000000060	Ga0214273_1065
c_000000000149	Ga0214273_1066
c_000000000067	Ga0214273_1067
c_000000000065	Ga0214273_1068
c_000000000145	Ga0214273_1069
c_000000000068	Ga0214273_1070
c_000000000143	Ga0214273_1071
c_000000000142	Ga0214273_1072
c_000000000088	Ga0214273_1073
c_000000000097	Ga0214273_1074
c_000000000249	Ga0214273_1075
c_000000000091	Ga0214273_1076
c_000000000302	Ga0214273_1077
c_000000000301	Ga0214273_1078
c_000000000120	Ga0214273_1079
c_000000000240	Ga0214273_1080
c_000000000263	Ga0214273_1081
c_000000000075	Ga0214273_1082
c_000000000074	Ga0214273_1083
c_000000000266	Ga0214273_1084
c_000000000076	Ga0214273_1085
c_000000000170	Ga0214273_1086
c_000000000171	Ga0214273_1087
c_000000000172	Ga0214273_1088
c_000000000174	Ga0214273_1089
c_000000000175	Ga0214273_1090
c_000000000048	Ga0214273_1091
c_000000000049	Ga0214273_1092
c_000000000047	Ga0214273_1093
c_000000000166	Ga0214273_1094
c_000000000345	Ga0214273_1095
c_000000000058	Ga0214273_1096
c_000000000052	Ga0214273_1097
c_000000000051	Ga0214273_1098
c_000000000201	Ga0214273_1099
c_000000000056	Ga0214273_1100
c_000000000204	Ga0214273_1101
c_000000000054	Ga0214273_1102
c_000000000113	Ga0214273_1103
c_000000000115	Ga0214273_1104
c_000000000260	Ga0214273_1105
c_000000000286	Ga0214273_1106
c_000000000284	Ga0214273_1107
c_000000000288	Ga0214273_1108
c_000000000289	Ga0214273_1109
c_000000000202	Ga0214273_1110
c_000000000458	Ga0214273_1111
c_000000000336	Ga0214273_1112
c_000000000335	Ga0214273_1113
c_000000000313	Ga0214273_1114
c_000000000291	Ga0214273_1115
c_000000000236	Ga0214273_1116
c_000000000045	Ga0214273_1117
c_000000000341	Ga0214273_1118
c_000000000627	Ga0214273_1119
c_000000000178	Ga0214273_1120
c_000000000179	Ga0214273_1121
c_000000000116	Ga0214273_1122
c_000000000161	Ga0214273_1123
c_000000001583	Ga0214273_1124
c_000000000093	Ga0214273_1125
