c_000000000219	Ga0182879_1001
c_000000000218	Ga0182879_1002
c_000000000211	Ga0182879_1003
c_000000000210	Ga0182879_1004
c_000000000213	Ga0182879_1005
c_000000000217	Ga0182879_1006
c_000000000216	Ga0182879_1007
c_000000000100	Ga0182879_1008
c_000000000103	Ga0182879_1009
c_000000000078	Ga0182879_1010
c_000000000108	Ga0182879_1011
c_000000000024	Ga0182879_1012
c_000000000025	Ga0182879_1013
c_000000000022	Ga0182879_1014
c_000000000023	Ga0182879_1015
c_000000000021	Ga0182879_1016
c_000000000294	Ga0182879_1017
c_000000000296	Ga0182879_1018
c_000000000199	Ga0182879_1019
c_000000000227	Ga0182879_1020
c_000000000139	Ga0182879_1021
c_000000000134	Ga0182879_1022
c_000000000135	Ga0182879_1023
c_000000000136	Ga0182879_1024
c_000000000130	Ga0182879_1025
c_000000000131	Ga0182879_1026
c_000000000132	Ga0182879_1027
c_000000000039	Ga0182879_1028
c_000000000038	Ga0182879_1029
c_000000000037	Ga0182879_1030
c_000000000032	Ga0182879_1031
c_000000000628	Ga0182879_1032
c_000000000352	Ga0182879_1033
c_000000000182	Ga0182879_1034
c_000000000187	Ga0182879_1035
c_000000000080	Ga0182879_1036
c_000000000081	Ga0182879_1037
c_000000000230	Ga0182879_1038
c_000000000084	Ga0182879_1039
c_000000000085	Ga0182879_1040
c_000000000086	Ga0182879_1041
c_000000000087	Ga0182879_1042
c_000000000123	Ga0182879_1043
c_000000000252	Ga0182879_1044
c_000000000209	Ga0182879_1045
c_000000000147	Ga0182879_1046
c_000000000006	Ga0182879_1047
c_000000000200	Ga0182879_1048
c_000000000050	Ga0182879_1049
c_000000000151	Ga0182879_1050
c_000000000012	Ga0182879_1051
c_000000000158	Ga0182879_1052
c_000000000159	Ga0182879_1053
c_000000000157	Ga0182879_1054
c_000000000154	Ga0182879_1055
c_000000000152	Ga0182879_1056
c_000000000150	Ga0182879_1057
c_000000000018	Ga0182879_1058
c_000000000233	Ga0182879_1059
c_000000000316	Ga0182879_1060
c_000000000011	Ga0182879_1061
c_000000000010	Ga0182879_1062
c_000000000062	Ga0182879_1063
c_000000000063	Ga0182879_1064
c_000000000060	Ga0182879_1065
c_000000000149	Ga0182879_1066
c_000000000067	Ga0182879_1067
c_000000000065	Ga0182879_1068
c_000000000145	Ga0182879_1069
c_000000000068	Ga0182879_1070
c_000000000143	Ga0182879_1071
c_000000000142	Ga0182879_1072
c_000000000088	Ga0182879_1073
c_000000000097	Ga0182879_1074
c_000000000249	Ga0182879_1075
c_000000000091	Ga0182879_1076
c_000000000302	Ga0182879_1077
c_000000000301	Ga0182879_1078
c_000000000120	Ga0182879_1079
c_000000000240	Ga0182879_1080
c_000000000263	Ga0182879_1081
c_000000000075	Ga0182879_1082
c_000000000074	Ga0182879_1083
c_000000000266	Ga0182879_1084
c_000000000076	Ga0182879_1085
c_000000000170	Ga0182879_1086
c_000000000171	Ga0182879_1087
c_000000000172	Ga0182879_1088
c_000000000174	Ga0182879_1089
c_000000000175	Ga0182879_1090
c_000000000048	Ga0182879_1091
c_000000000049	Ga0182879_1092
c_000000000047	Ga0182879_1093
c_000000000166	Ga0182879_1094
c_000000000345	Ga0182879_1095
c_000000000058	Ga0182879_1096
c_000000000052	Ga0182879_1097
c_000000000051	Ga0182879_1098
c_000000000201	Ga0182879_1099
c_000000000056	Ga0182879_1100
c_000000000204	Ga0182879_1101
c_000000000054	Ga0182879_1102
c_000000000113	Ga0182879_1103
c_000000000115	Ga0182879_1104
c_000000000260	Ga0182879_1105
c_000000000286	Ga0182879_1106
c_000000000284	Ga0182879_1107
c_000000000288	Ga0182879_1108
c_000000000289	Ga0182879_1109
