c_000000000083	Ga0214274_101
c_000000000044	Ga0214274_102
c_000000000121	Ga0214274_103
c_000000000126	Ga0214274_104
c_000000000066	Ga0214274_105
c_000000000001	Ga0214274_106
c_000000000002	Ga0214274_107
c_000000000003	Ga0214274_108
c_000000000004	Ga0214274_109
c_000000000005	Ga0214274_110
c_000000000007	Ga0214274_111
c_000000000036	Ga0214274_112
c_000000000298	Ga0214274_113
c_000000000059	Ga0214274_114
c_000000000057	Ga0214274_115
c_000000000017	Ga0214274_116
c_000000000016	Ga0214274_117
c_000000000014	Ga0214274_118
c_000000000035	Ga0214274_119
c_000000000119	Ga0214274_120
c_000000000031	Ga0214274_121
c_000000000030	Ga0214274_122
c_000000000019	Ga0214274_123
c_000000000112	Ga0214274_124
c_000000000247	Ga0214274_125
c_000000000105	Ga0214274_126
c_000000000180	Ga0214274_127
c_000000000185	Ga0214274_128
c_000000000029	Ga0214274_129
