c_000000000291	Ga0182893_101
c_000000000236	Ga0182893_102
c_000000000045	Ga0182893_103
c_000000000341	Ga0182893_104
c_000000000627	Ga0182893_105
c_000000000178	Ga0182893_106
c_000000000179	Ga0182893_107
c_000000000116	Ga0182893_108
c_000000000161	Ga0182893_109
c_000000001583	Ga0182893_110
c_000000000093	Ga0182893_111
