c_000000001682	Ga0182881_1001
c_000000000212	Ga0182881_1002
c_000000000215	Ga0182881_1003
c_000000000214	Ga0182881_1004
c_000000000101	Ga0182881_1005
c_000000000268	Ga0182881_1006
c_000000000102	Ga0182881_1007
c_000000000104	Ga0182881_1008
c_000000000107	Ga0182881_1009
c_000000000106	Ga0182881_1010
c_000000000026	Ga0182881_1011
c_000000000027	Ga0182881_1012
c_000000000020	Ga0182881_1013
c_000000000290	Ga0182881_1014
c_000000000293	Ga0182881_1015
c_000000000292	Ga0182881_1016
c_000000000614	Ga0182881_1017
c_000000000902	Ga0182881_1018
c_000000000198	Ga0182881_1019
c_000000000192	Ga0182881_1020
c_000000000190	Ga0182881_1021
c_000000000191	Ga0182881_1022
c_000000000196	Ga0182881_1023
c_000000000197	Ga0182881_1024
c_000000000194	Ga0182881_1025
c_000000000224	Ga0182881_1026
c_000000000225	Ga0182881_1027
c_000000000226	Ga0182881_1028
c_000000000220	Ga0182881_1029
c_000000000221	Ga0182881_1030
c_000000001434	Ga0182881_1031
c_000000000223	Ga0182881_1032
c_000000000137	Ga0182881_1033
c_000000000343	Ga0182881_1034
c_000000000229	Ga0182881_1035
c_000000000133	Ga0182881_1036
c_000000000034	Ga0182881_1037
c_000000000033	Ga0182881_1038
c_000000000189	Ga0182881_1039
c_000000000188	Ga0182881_1040
c_000000000256	Ga0182881_1041
c_000000000183	Ga0182881_1042
c_000000000184	Ga0182881_1043
c_000000000186	Ga0182881_1044
c_000000000232	Ga0182881_1045
c_000000000129	Ga0182881_1046
c_000000000128	Ga0182881_1047
c_000000000237	Ga0182881_1048
c_000000000028	Ga0182881_1049
c_000000000234	Ga0182881_1050
c_000000000122	Ga0182881_1051
c_000000000330	Ga0182881_1052
c_000000000127	Ga0182881_1053
c_000000000125	Ga0182881_1054
c_000000000124	Ga0182881_1055
c_000000000008	Ga0182881_1056
c_000000000109	Ga0182881_1057
c_000000000636	Ga0182881_1058
c_000000000433	Ga0182881_1059
c_000000000069	Ga0182881_1060
c_000000000258	Ga0182881_1061
c_000000000203	Ga0182881_1062
c_000000001049	Ga0182881_1063
c_000000001027	Ga0182881_1064
c_000000000015	Ga0182881_1065
c_000000000013	Ga0182881_1066
c_000000000241	Ga0182881_1067
c_000000000156	Ga0182881_1068
c_000000000155	Ga0182881_1069
c_000000000153	Ga0182881_1070
c_000000000239	Ga0182881_1071
c_000000000242	Ga0182881_1072
c_000000000117	Ga0182881_1073
c_000000000254	Ga0182881_1074
c_000000000257	Ga0182881_1075
c_000000000061	Ga0182881_1076
c_000000000251	Ga0182881_1077
c_000000000148	Ga0182881_1078
c_000000000253	Ga0182881_1079
c_000000000394	Ga0182881_1080
c_000000000144	Ga0182881_1081
c_000000000146	Ga0182881_1082
c_000000000141	Ga0182881_1083
c_000000000140	Ga0182881_1084
c_000000000659	Ga0182881_1085
c_000000000867	Ga0182881_1086
c_000000000270	Ga0182881_1087
c_000000000099	Ga0182881_1088
c_000000000098	Ga0182881_1089
c_000000000096	Ga0182881_1090
c_000000000094	Ga0182881_1091
c_000000000092	Ga0182881_1092
c_000000000090	Ga0182881_1093
c_000000000306	Ga0182881_1094
c_000000000305	Ga0182881_1095
c_000000000304	Ga0182881_1096
c_000000000071	Ga0182881_1097
c_000000000070	Ga0182881_1098
c_000000000262	Ga0182881_1099
c_000000000072	Ga0182881_1100
c_000000000077	Ga0182881_1101
c_000000000079	Ga0182881_1102
c_000000000380	Ga0182881_1103
c_000000000173	Ga0182881_1104
c_000000000176	Ga0182881_1105
c_000000000177	Ga0182881_1106
c_000000000009	Ga0182881_1107
c_000000000279	Ga0182881_1108
c_000000000046	Ga0182881_1109
c_000000000160	Ga0182881_1110
c_000000000040	Ga0182881_1111
c_000000000041	Ga0182881_1112
c_000000000042	Ga0182881_1113
c_000000000043	Ga0182881_1114
c_000000000167	Ga0182881_1115
c_000000000165	Ga0182881_1116
c_000000000164	Ga0182881_1117
c_000000000163	Ga0182881_1118
c_000000000162	Ga0182881_1119
c_000000000371	Ga0182881_1120
c_000000000138	Ga0182881_1121
c_000000000169	Ga0182881_1122
c_000000000168	Ga0182881_1123
c_000000000222	Ga0182881_1124
c_000000000968	Ga0182881_1125
c_000000000053	Ga0182881_1126
c_000000000228	Ga0182881_1127
c_000000000206	Ga0182881_1128
c_000000000207	Ga0182881_1129
c_000000000055	Ga0182881_1130
c_000000000205	Ga0182881_1131
c_000000000365	Ga0182881_1132
c_000000000110	Ga0182881_1133
c_000000000111	Ga0182881_1134
c_000000000360	Ga0182881_1135
c_000000000114	Ga0182881_1136
c_000000000118	Ga0182881_1137
c_000000000261	Ga0182881_1138
c_000000000073	Ga0182881_1139
c_000000000064	Ga0182881_1140
