c_000000000083	Ga0182890_101
c_000000000044	Ga0182890_102
c_000000000121	Ga0182890_103
c_000000000126	Ga0182890_104
c_000000000066	Ga0182890_105
c_000000000001	Ga0182890_106
c_000000000002	Ga0182890_107
c_000000000003	Ga0182890_108
c_000000000004	Ga0182890_109
c_000000000005	Ga0182890_110
c_000000000007	Ga0182890_111
c_000000000036	Ga0182890_112
c_000000000298	Ga0182890_113
c_000000000059	Ga0182890_114
c_000000000057	Ga0182890_115
c_000000000017	Ga0182890_116
c_000000000016	Ga0182890_117
c_000000000014	Ga0182890_118
c_000000000035	Ga0182890_119
c_000000000119	Ga0182890_120
c_000000000031	Ga0182890_121
c_000000000030	Ga0182890_122
c_000000000019	Ga0182890_123
c_000000000112	Ga0182890_124
c_000000000247	Ga0182890_125
c_000000000105	Ga0182890_126
